// Level 1
111111118 111111111
100200000 010000001
111110110 010111101
101000000 000100101
101011111 111001101

101010000 000000001
100011110 110111101
101010000 110020101
101000100 101001001
191111111 111111111

