// Level 4
111111118 111111111
100000000 000000001
101111110 111111101
101000000 000000101
101001000 010000101

101100100 010001101
101000000 000000101
101111111 111111101
100000000 000000001
111111119 111111111

