// Level 2
111111111 111111111
100300000 000000008
100011111 111111111
100000000 000000001
111111111 111111101

100010000 103000001
100010000 111110001
100010000 100010001
100010000 100010009
111111111 111111111

