// Level 2
111111111 111111111
100300000 000000008
100011111 111111011
100000000 000000001
111111011 111111111

100010000 003000001
100010000 111110001
100010000 100010001
100000000 100000009
111111111 111111111

