// Level 1
111111118 111111111
100200000 100000001
111111110 111111111
101000010 100100101
101011110 111001101

101010010 100000001
100011110 110111101
111111110 110020101
100000000 101001001
191111111 111111111

