// Level 4
111111111 118111111
100000000 000000001
101111100 111111001
100000000 000000001
100111100 010101101

100000000 000000001
100000010 000000001
101100000 000000001
100000010 000000001
111119111 111111111

