// Level 3
181111111 111111111
101000000 000000001
101010000 000000101
101011111 111000101
100010000 000000101

110111111 110000101
100000000 111101009
100000000 000001011
100000000 000001041
111111111 111111111

